##############
#*******######
#************#
#************#
#*******##***#
##########***#
###*##*###***#
###*##*###***#
##########***#
#*######*#***#
##******##***#
##########***#

