#####################################################
#*******#######*************##**********************#
#************##*************##**********************#
#************##*************##**********************#
#*******##***##*************##******###*************#
##########***##*************##******###*************#
###*##*###***##*************##******###*************#
###*##*###***##*************##**********************#
##########***##*************##**********************#
#*######*#***##*************##**********************#
##******##***##*************##**********************#
##########***##*************##**********************#
#***************************************************#
#***************************************************#
#***************************************************#
#####################*******##########**************#
#####################*******##########**************#
#####################*******###*********************#
#####################*******###*********************#
#***************************###*********************#
#***************************###*********************#
#***************************###*********************#
#####################################################
