###############
##    #### ## #
#   # ##      #
##### ## ### ##
##       ###  #
## #####     ##
#  ##    ### ##
# ### ## ######
##### ###### ##
#     ###     #
#####     ## ##
# ### #########
#             #
# # ####### ###
#   ##        #
###############