#####################################################
#*******#######*************##**********************#
#************##*************##**********************#
#************##*************##**********************#
#*******##***##*************##******###*************#
##########***##*************##******###*************#
###*##*###***##*************##******###*************#
###*##*###***##*************##**********************#
##########***##*************##**********************#
#*######*#***##*************##**********************#
##******##***##*************##**********************#
##########***##*************##**********************#
#***************************************************#
#***************************************************#
#***************************************************#
#####################*******##########**************#
