#############################################
##    #### ## ###    #### ## ###    #### ## #
#   # ##      ##   # ##           # ##      #
##### ## ### #### ## ## ### ####### ## ### ##
##       ###            ###  ###       ###  #
## #####     #### #####     #### #####     ##
#  ##    ### ###  ##             ##    ### ##
#############################################