###################
### ### ####      #
###          #### #
############ #    #
#         ## ######
#     ### ##    ###
### ##### ##### ###
###             ###
### ########## ####
### ########## ####
###      ##### ####
### #### ## ## ####
#     #  ##    ####
### ### ### #######
#     #          ##
####### ######## ##
#       ######## ##
# ########       ##
# #######   #######
###################